śṛṇvaṃś ca sarvadharmeṣv aniśritasaṃjñām utpādayati sma |tasyānekāni samādhimukhāny āmukhībhūtāny abhūvan |tadyathā sarva
dharmasvabhāvavyavalokano nāma samādhiḥ |sarvadharmasvabhāvānupalabdhir nāma samādhiḥ |sarvadharmasvabhāvajñānanirgamo n
āma samādhiḥ |sarvadharmanirnānātvo nāma samādhiḥ |sarvadharmanirvikāradarśī nāma samādhiḥ |sarvadharmāvabhāsakaro nāma 
samādhiḥ |sarvadharmatamopagato nāma samādhiḥ |sarvadharmajñānavidhvaṃsano nāma samādhiḥ |sarvadharmavidhūnano nāma samā
dhiḥ |sarvadharmānupalabdhir nāma samādhiḥ |kusumābhikīrṇo nāma samādhiḥ |sarvadharmātmabhāvābhinirhāro nāma samādhiḥ |m
āyāvivarjito nāma samādhiḥ |ādarśamaṇḍalapratibhāsanirhāro nāma samādhiḥ |sarvasattvarutanirhāro nāma samādhiḥ |rajopaga
to nāma samādhiḥ |sarvasattvābhipramodano nāma samādhiḥ |sarvasattvarutakauśalyānugato nāma samādhiḥ |nānārutapadavyañja
nābhinirhāro nāma samādhiḥ |astambhito nāma samādhiḥ |prakṛtyavyavahāro nāma samādhiḥ |anāvaraṇavimokṣaprāpto nāma samād
hiḥ |rājopagato nāma samādhiḥ |nāmaniruktipadavyañjano nāma samādhiḥ |sarvadharmavipaśyano nāma samādhiḥ |sarvadharmaviṣ
ayāpagato nāma samādhiḥ |sarvadharmānāvaraṇakoṭirnāma samādhiḥ |gaganakalpo nāma samādhiḥ |vajropamo nāma samādhiḥ |āsan
narūparājo nāma samādhiḥ |asapatnarājo nāma samādhiḥ |jayalabdho nāma samādhiḥ |avivartyacakṣurnāma samādhiḥ |dharmadhāt
uniyato nāma samādhiḥ |dharmadhātunirgato nāma samādhiḥ |āśvāsadātā nāma samādhiḥ |siṃhābhigarjito (243) nāma samādhiḥ |
sarvasattvābhibhavano nāma samādhiḥ |vigatarajo nāma samādhiḥ |asaṃkliṣṭo nāma samādhiḥ |padmavyūho nāma samādhiḥ |kāṅkṣ
occhedano nāma samādhiḥ |sarvasārānugato nāma samādhiḥ |sarvadharmābhyudgato nāma samādhiḥ |abhijñābalavaiśāradyaprāpto 
nāma samādhiḥ |sarvadharmanirvedhako nāma samādhiḥ |sarvadharmavibhavamudrā nāma samādhiḥ |sarvadharmavibhavasamudro nām
a samādhiḥ |sarvadharmanirviśeṣadarśī nāma samādhiḥ |sarvadṛṣṭikṛtagahanavivarjito nāma samādhiḥ |tamopagato nāma samādh
iḥ |sarvadharmanimittāpagato nāma samādhiḥ |sarvasaṅgavimukto nāma samādhiḥ |sarvakausīdyāpagato nāma samādhiḥ |gambhīra
dharmaprabhākaro nāma samādhiḥ |merukalpo nāma samādhiḥ |asaṃhāryo nāma samādhiḥ |māramaṇḍalavidhvaṃsanakaro nāma samādh
iḥ |trailokyānabhiniviṣṭo nāma samādhiḥ |raśminirhāro nāma samādhiḥ |tathāgatadarśano nāma samādhiḥ |sarvatathāgatadarśī
nāma samādhiḥ |sa eṣu samādhiṣu sthitaḥ san daśadiśi loke buddhān bhagavataḥ paśyati smāprameyān asaṃkhyeyān imām eva p
rajñāpāramitāṃ prakāśayato bodhisattvebhyo mahāsattvebhyaḥ |te ca tathāgatāḥ sādhukāraṃ dadati sma, svāsanaṃ cāsya kurva
nti sma |evaṃ cāvocan - asmābhir api kulaputra pūrvaṃ bodhisattvacaryāṃ caradbhir evam eva prajñāpāramitā parigaveṣitā |
parigaveṣamāṇaiś ca ete eva samādhayaḥ pratilabdhāḥ, ye tvayaitarhi pratilabdhāḥ |enāṃś ca samādhīn pratilabhya gatiṃgat
āḥ saṃvṛttāḥ, prajñāpāramitāyām avinivartanīyeṣu buddhadharmeṣu pratiṣṭhitāḥ |te vayam eteṣām eva samādhīnāṃ prakṛtiṃ sv
abhāvaṃ vyavalokayan tas taṃ dharmaṃ na samanupaśyāmo yaḥ samāpadyate vā vyuttiṣṭhate vā, yo bodhāya caret, yo vā anutta
rāṃ samyaksaṃbodhim abhisaṃbudhyeta |iyaṃ sā kulaputra prajñāpāramitā, yā na kenacid dharmeṇa manyamānatā |amanyamānatās
thitair asmābhir iyam evaṃrūpā kāyasya suvarṇavarṇatā pratilabdhā |dvātriṃśac ca mahāpuruṣalakṣaṇāni |aśītiś cānuvyañjan
āni |vyāmaprabhatā ca |acintyaṃ cānuttaraṃ buddhajñānaṃ buddhaprajñā, anuttaraś ca buddhasamādhiḥ, sarvabuddhadharmaguṇa
pāramitā cānuprāptā yasyā guṇapāramitāyā na śakyaṃ tathāgatair eva tāvat pramāṇaṃ grahītuṃ paryanto vā nidarśayitum, kiṃ
punaḥ śrāvakapratyekabuddhaiḥ? tasmāt tarhi kulaputra eteṣv eva tvayā dharmeṣu gauravam utpādayitavyaṃ bhūyasyā mātrayā
arthikatayā chandikatayā ca |arthikasya hi kulaputra chandikasya ca na durlabhā bhavaty anuttarā samyaksaṃbodhiḥ |kalyā
ṇamitreṣu ca tvayā kulaputra tīvraṃ gauravam utpādayitavyam, prema ca karaṇīyam, prasādaś ca karaṇīyaḥ |kalyāṇamitrapari
gṛhītā hi bodhisattvā mahāsattvāḥ kṣipram evānuttarāṃ samyaksaṃbodhim abhisaṃbudhyante ||

atha khalu sadāprarudito bodhisattvo mahāsattvas tāṃs tathāgatān etad avocat - ko ’smākaṃ kalyāṇamitram iti? ta enam etad
avocan - dīrgharātraṃ tvaṃ kulaputra dharmodgatena bodhisattvena mahāsattvenānuttarāyāṃ samyaksaṃbodhau paripācitaḥ par
igṛhītaś ca |prajñāpāramitāyām upāyakauśalye buddhadharmeṣu ca śikṣāpitaḥ |sa tava kulaputra parigrāhakaḥ kalyāṇamitraṃ 
ca |tat tvayā kṛtajñatayā kṛtaveditayā ca satkṛtya tatkṛtaṃ dhārayitavyam |sacet tvaṃ kulaputra dharmodgataṃ bodhisattva
ṃ (244) mahāsattvam ekaṃ vā kalpaṃ dvau vā kalpau trīn vā kalpān kalpaśataṃ vā kalpasahasraṃ vā kalpaśatasahasraṃ vā tat
o vottare cailoṇḍukamiva śirasā parikarṣeḥ, sarvasattvasukhopasthānaṃ cāsyopasthāpayeḥ, yāvantas trisāhasramahāsāhasre l
okadhātau rūpaśabdagandharasasparśāḥ, tān sarvān upanāmayeḥ |evam api tvayā kulaputra tasya kulaputrasya naiva kṛtasya p
ratikṛtaṃ bhavet |tat kasya hetoḥ? tasya hi kulaputra kulaputrasyānubhāvena tavaiṣām evaṃrūpāṇāṃ samādhīnāṃ pratilambhaḥ
saṃvṛttaḥ |prajñāpāramitopāyakauśalyaśravaś ca prajñāpāramitāpratilambhaś ca saṃvṛttaḥ ||

