anugamaparivarta ekonatriṃśattamaḥ |

punar aparaṃ subhūte bodhisattvena mahāsattvena evaṃ prajñāpāramitā anugantavyā - sarvadharmāsaṅgataḥ prajñāpāramitā anug
antavyā |sarvadharmāsaṃbhedanataḥ prajñāpāramitā anugantavyā |sarvadharmāsaṃbhavataḥ prajñāpāramitā anugantavyā |sarvadh
armānirvikārasamā iti prajñāpāramitā anugantavyā |sarvadharmāṇām anātmavijñaptitaḥ prajñānubodhanataḥ prajñāpāramitā anu
gantavyā |sarvadharmāś ca nāmamātreṇa vyavahāramātreṇābhilapyante iti prajñāpāramitā anugantavyā |vyavahāraś ca na kvaci
n na kutaścin na kaścid vyavahāraḥ |sarvadharmā avyavahārā avyāhārā avyavahṛtā avyāhṛtā iti prajñāpāramitā anugantavyā |
sarvadharmāpramāṇataḥ prajñāpāramitā anugantavyā |rūpāpramāṇataḥ prajñāpāramitā anugantavyā |evaṃ vedanāpramāṇataḥ saṃjñ
āpramāṇataḥ saṃskārāpramāṇataḥ |vijñānāpramāṇataḥ prajñāpāramitā anugantavyā |sarvadharmānimittataḥ prajñāpāramitā anuga
ntavyā |sarvadharmanirvedhataḥ prajñāpāramitā anugantavyā |sarvadharmaprakṛtipariśuddhitaḥ prajñāpāramitā anugantavyā |s
arvadharmāvacanataḥ prajñāpāramitā anugantavyā |sarvadharmāṇām anirodhataḥ prahāṇasamatayā prajñāpāramitā anugantavyā |s
arvadharmāṇāṃ nirvāṇaprāptitas tathatāsamatayā prajñāpāramitā anugantavyā |sarvadharmā nāgacchanti, na gacchanti, ajānān
ā ajātā atyantājātita iti prajñāpāramitā anugantavyā |ātmaparādarśanataḥ prajñāpāramitā anugantavyā |sarvadharmā āryārha
ntaḥ prakṛtipariśuddhā iti prajñāpāramitā anugantavyā |apahṛtabhārāḥ sarvadharmābhārānāropaṇatayeti prajñāpāramitā anuga
ntavyā |sarvadharmādeśāpradeśataḥ prajñāpāramitā anugantavyā |tat kasya hetoḥ? rūpaṃ hi subhūte adeśam apradeśaṃ prakṛti
svabhāvataḥ |evaṃ vedanā saṃjñā saṃskārāḥ |vijñānaṃ hi subhūte adeśam apradeśaṃ prakṛītisvabhāvataḥ sarvadharmanirodhapr
ahlādanatvād iti prajñāpāramitā anugantavyā |aratyaviratitaḥ prajñāpāramitā anugantavyā |araktāviraktatayā prajñāpāramit
ā anugantavyā |tat kasya hetoḥ? rūpaṃ hi subhūte satattvena svabhāvena na rajyate na virajyate |evaṃ vedanā saṃjñā saṃsk
ārāḥ |vijñānaṃ hi subhūte satattvena svabhāvena na rajyate na virajyate prakṛtipariśuddhatvād iti prajñāpāramitā anugant
avyā |sarvadharmā asaktāḥ saṅgāsaṅgavigatā iti prajñāpāramitā anugantavyā |bodhiḥ sarvadharmā buddhajñānāvabodhanatayeti
prajñāpāramitā anugantavyā |sarvadharmaśūnyānimittāpraṇihitatayā prajñāpāramitā anugantavyā |sarvadharmā bhaiṣajyamaitr
īpūrvaṃgamatayeti prajñāpāramitā anugantavyā |sarvadharmā maitrīvihāriṇaḥ karuṇāvihāriṇo muditāvihāriṇa upekṣāvihāriṇa i
ti prajñāpāramitā anugantavyā |sarvadharmā brahmabhūtā doṣānutpādanataḥ sarvadoṣānutpādanata iti prajñāpāramitā anuganta
vyā |sarvadharmāṇām apraṇihitato ’pratihatita iti prajñāpāramitā anugantavyā |samudrāparyantatayā prajñāpāramitāparyanta
tā anugantavyā |gaganāparyantatayā prajñāpāramitāparyantatā anugantavyā |meruvicitratayā prajñāpāramitāvicitratā anugant
avyā |rūpāparyantatayā prajñāpāramitāparyantatā (236) anugantavyā |evaṃ vedanā saṃjñā saṃskārāḥ |vijñānāparyantatayā pra
jñāpāramitāparyantatā anugantavyā |sūryaraśmimaṇḍalāparyantāvabhāsanatayā prajñāpāramitāparyantatā anugantavyā |sarvaśab
dāparyantatayā prajñāpāramitāparyantatā anugantavyā |sarvabuddhadharmasamudāgamāparyantatayā prajñāpāramitāparyantatā an
ugantavyā |sarvasattvadhātupuṇyajñānasaṃbhārāparyantatayā prajñāpāramitāparyantatā anugantavyā |pṛthivīdhātvaparyantatay
ā prajñāpāramitāparyantatā anugantavyā |evam abdhātutejodhātuvāyudhātvākāśadhātuvijñānadhātvaparyantatayā prajñāpāramitā
paryantatā anugantavyā |kuśalākuśaladharmasaṃcayāpramāṇatayā prajñāpāramitāpramāṇatā anugantavyā |sarvadharmasaṃcayāpram
āṇatayā prajñāpāramitāpramāṇatā anugantavyā |sarvadharmasamādhyaparyantatāpratilambhitayā prajñāpāramitāparyantatā anuga
ntavyā |sarvabuddhadharmāparyantatayā prajñāpāramitāparyantatā anugantavyā |sarvadharmāparyantatayā prajñāpāramitāparyan
tatā anugantavyā |śūnyatāparyantatayā prajñāpāramitāparyantatā anugantavyā |cittacaitasikāparyantatayā prajñāpāramitāpar
yantatā anugantavyā |cittacaritāparyantatayā prajñāpāramitāparyantatā anugantavyā |kuśalākuśaladharmāparimāṇatayā prajñā
pāramitāparimāṇatā anugantavyā |siṃhanādanadanatayā prajñāpāramitānadanatā anugantavyā |sarvadharmākopyatayā prajñāpāram
itākopyatā anugantavyā |tat kasya hetoḥ? rūpaṃ hi subhūte samudrasamam | evaṃ vedanāṃ saṃjñā saṃskārāḥ | vijñānaṃ hi sub
hūte samudrasamam |rūpaṃ hi gaganasamam | evaṃ vedanā saṃjñā saṃskārāḥ | vijñānaṃ gaganasamam |rūpaṃ vicitramerusamam | 
evaṃ vedanā saṃjñā saṃskārāḥ | vijñānaṃ vicitramerusamam |rūpam aparyantasamam | evaṃ vedanā saṃjñā saṃskārāḥ | vijñānam
aparyantasamam |rūpaṃ sūryamaṇḍalaraśmyutpādasamam | evaṃ vedanā saṃjñā saṃskārāḥ | vijñānaṃ sūryamaṇḍalaraśmyutpādasam
am |rūpaṃ sarvaśabdāparyantasamam | evaṃ vedanā saṃjñā saṃskārāḥ | vijñānaṃ sarvaśabdāparyantasamam |rūpaṃ sarvasattvadh
ātvaparyantasamam | evaṃ vedanā saṃjñā saṃskārāḥ | vijñānaṃ sarvasattvadhātvaparyantasamam |rūpaṃ sarvabuddhadharmasamud
āgamāparyantasamam | evaṃ vedanā saṃjñā saṃskārāḥ | vijñānaṃ sarvabuddhadharmasamudāgamāparyantasamam |rūpaṃ sarvasattva
dhātupuṇyajñānasaṃbhārāparyantasamam | evaṃ vedanā saṃjñā saṃskārāḥ | vijñānaṃ sarvasattvadhātupuṇyajñānasaṃbhārāparyant
asamam |rūpaṃ pṛthivīsamam | evaṃ vedanā saṃjñā saṃskārāḥ | vijñānaṃ pṛthivīsamam |rūpam apsamam | evaṃ vedanā saṃjñā sa
ṃskārāḥ | vijñānam apsamam |rūpaṃ tejaḥsamam | evaṃ vedanā saṃjñā saṃskārāḥ | vijñānaṃ tejaḥsamam |rūpaṃ vāyusamam | eva
ṃ vedanā saṃjñā saṃskārāḥ | vijñānaṃ vāyusamam |rūpam ākāśasamam | evaṃ vedanā saṃjñā saṃskārāḥ | vijñānam ākāśasamam |r
ūpaṃ vijñānasamam | evaṃ vedanā saṃjñā saṃskārāḥ | vijñānaṃ vijñānasamam |rūpaṃ kuśalākuśaladharmasaṃcayavigatam | evaṃ 
vedanā saṃjñā saṃskārāḥ | vijñānaṃ kuśalākuśaladharmasaṃcayavigatam |rūpaṃ sarvadharmasaṃcayavigatam | evaṃ vedanā saṃjñ
ā saṃskārāḥ | vijñānaṃ sarvadharmasaṃcayavigatam |rūpaṃ sarvadharmasamādhyaparyantatāsamam | evaṃ vedanā saṃjñā saṃskārā
ḥ | vijñānaṃ sarvadharmasamādhyaparyantatāsamam |rūpaṃ vigamaḥ, rūpasvabhāvo rūpatathatā buddhadharmāḥ | evaṃ vedanā saṃ
jñā saṃskārāḥ | vijñānaṃ vigamaḥ, (237) vijñānasvabhāvo vijñānatathatā buddhadharmāḥ |rūpaṃ sarvadharmāparyantadharmatā 
| evaṃ vedanā saṃjñā saṃskārāḥ | vijñānaṃ sarvadharmāparyantadharmatā |rūpaṃ śūnyam aparyantadharmatā | evaṃ vedanā saṃj
ñā saṃskārāḥ | vijñānaṃ śūnyam aparyantadharmatā |rūpaṃ cittacaitasikāparyantatā | evaṃ vedanā saṃjñā saṃskārāḥ | vijñān
aṃ cittacaitasikāparyantatā |rūpaṃ cittacaritotpattiḥ | evaṃ vedanā saṃjñā saṃskārāḥ | vijñānaṃ cittacaritotpattiḥ |rūpa
ṃ kuśalam akuśalam, yāvad anupalabdhiḥ | evaṃ vedanā saṃjñā saṃskārāḥ | vijñānaṃ kuśalam akuśalam, yāvad anupalabdhiḥ |r
ūpaṃ siṃhanādasamam | evaṃ vedanā saṃjñā saṃskārāḥ | vijñānaṃ siṃhanādasamam |rūpam akopyam | evaṃ vedanā saṃjñā saṃskār
āḥ | vijñānam akopyam |evaṃ hi subhūte bodhisattvena mahāsattvena prajñāpāramitā anugantavyā ||

yadāyaṃ subhūte bodhisattvo mahāsattva evam enāṃ prajñāpāramitām anugamiṣyati, vyavacārayiṣyati avatariṣyati avabhotsyate
cintayiṣyati tulayiṣyati upaparīkṣiṣyate bhāvayiṣyati sarvamāyāśāṭhyavivarjitair manasikāraiḥ, sarvamanyanāvivarjitair 
manasikāraiḥ, ātmotkarṣaṇavivarjitair manasikāraiḥ, sarvakausīdyavivarjitair manasikāraiḥ, parapaṃsanāvivarjitair manasi
kāraiḥ, ātmasaṃjñāvivarjitair manasikāraiḥ, sattvasaṃjñāvivarjitair manasikāraiḥ, lābhasatkāraślokavivarjitair manasikār
aiḥ, pañcanīvaraṇavivarjitair manasikāraiḥ, īrṣyāmātsaryavivarjitair manasikāraiḥ, sarveñjanāvivarjitair manasikāraiḥ, t
adā nāsya durlabhā bhaviṣyati sarvaguṇānāṃ paripūriḥ, buddhakṣetrasyānuttarāṇāṃ ca buddhadharmāṇāṃ paripūrir iti ||

āryāṣṭasāhasrikāyāṃ prajñāpāramitāyām anugamaparivarto nāmaikonatriṃśattamaḥ || (238)

