evam ukte āyuṣmān subhūtir bhagavantam etad avocat - asatpāramiteyaṃ bhagavan ākāśasattām upādāya |asamasamatāpāramiteyaṃ
bhagavan sarvadharmānupalabdhitām upādāya |viviktapāramiteyaṃ bhagavan atyantaśūnyatām upādāya |anavamṛdyapāramiteyaṃ b
hagavan sarvadharmānupalabdhitām upādāya |apadapāramiteyaṃ bhagavan anāmāśarīratām upādāya |asvabhāvapāramiteyaṃ bhagava
n anāgatim agatim upādāya |avacanapāramiteyaṃ bhagavan sarvadharmāvikalpatām upādāya |anāmapāramiteyaṃ bhagavan skandhān
upalabdhitām upādāya |agamanapāramiteyaṃ bhagavan sarvadharmāgamanatām upādāya |asaṃhāryapāramiteyaṃ bhagavan sarvadharm
āgrāhyatām upādāya |akṣayapāramiteyaṃ bhagavan akṣayadharmayogatām upādāya |anutpattipāramiteyaṃ bhagavan sarvadharmānab
hinirvṛttitām upādāya |akārakapāramiteyaṃ bhagavan kārakānupalabdhitām upādāya |ajānakapāramiteyaṃ bhagavan sarvadharmāṇ
āmanātmatām upādāya |asaṃkrāntipāramiteyaṃ bhagavan cyutyupapattyanupattitām upādāya |avinayapāramiteyaṃ bhagavan pūrvān
tāparāntapratyutpannārthānupalabdhitām upādāya |svapnapratiśrutkāpratibhāsamarīcimāyāpāramiteyaṃ bhagavan anutpādavijñāp
anatām upādāya |asaṃkleśapāramiteyaṃ bhagavan rāgadveṣamohāsvabhāvatām upādāya |avyavadānapāramiteyaṃ bhagavan āśrayānup
alabdhitām upādāya |anupalepapāramiteyaṃ bhagavan ākāśānupalepatām upādāya |aprapañcapāramiteyaṃ bhagavan sarvadharmaman
anasamatikramatām upādāya |amananapāramiteyaṃ bhagavan aniñjanatām upādāya |acalitapāramiteyaṃ bhagavan dharmadhātusthit
itām upādāya |virāgapāramiteyaṃ bhagavan sarvadharmāvitathatām upādāya |asamutthānapāramiteyaṃ bhagavan sarvadharmanirvi
kalpatām upādāya |śāntapāramiteyaṃ bhagavan sarvadharmanimittānupalabdhitām upādāya |nirdoṣapāramiteyaṃ bhagavan guṇapār
amitām upādāya |niḥkleśapāramiteyaṃ bhagavan parikalpāsattām upādāya |niḥsattvapāramiteyaṃ bhagavan bhūtakoṭitām upādāya
|apramāṇapāramiteyaṃ bhagavan sarvadharmasamutthānāsamutthānatām upādāya |antadvayānanugamapāramiteyaṃ bhagavan sarvadh
armānabhiniveśanatām upādāya |asaṃbhinnapāramiteyaṃ bhagavan sarvadharmāsaṃbhedanatām upādāya |aparāmṛṣṭapāramiteyaṃ bha
gavan sarvaśrāvakapratyekabuddhabhūmyaspṛhaṇatām upādāya |avikalpapāramiteyaṃ bhagavan vikalpasamatām upādāya |aprameyap
āramiteyaṃ bhagavan apramāṇadharmatām upādāya |asaṅgapāramiteyaṃ bhagavan sarvadharmāsaṅgatām upādāya |anityapāramiteyaṃ
bhagavan sarvadharmāsaṃskṛtatām upādāya |duḥkhapāramiteyaṃ bhagavan ākāśasamadharmatām upādāya |śūnyapāramiteyaṃ bhagav
an sarvadharmānupalabdhitām upādāya |anātmapāramiteyaṃ bhagavan sarvadharmānabhiniveśanatām upādāya |alakṣaṇapāramiteyaṃ
bhagavan sarvadharmānabhinirvṛttitām upādāya (103) |sarvaśūnyatāpāramiteyaṃ bhagavan anantāparyantatām upādāya |smṛtyup
asthānādibodhipakṣadharmapāramiteyaṃ bhagavaṃs teṣām anupalabdhitām upādāya |śūnyatānimittāpraṇihitapāramiteyaṃ bhagavan
trivimokṣamukhānupalabdhitām upādāya |aṣṭavimokṣapāramiteyaṃ bhagavaṃs teṣām anupalabdhitām upādāya |navānupūrvavihārap
āramiteyaṃ bhagavan prathamadhyānādīnām anupalabdhitām upādāya |catuḥsatyapāramiteyaṃ bhagavan duḥkhādīnām anupalabdhitā
m upādāya |daśapāramiteyaṃ bhagavan dānādīnām anupalabdhitām upādāya |balapāramiteyaṃ bhagavan anavamṛdyatām upādāya |va
iśāradyapāramiteyaṃ bhagavan atyantānavalīnatām upādāya |pratisaṃvitpāramiteyaṃ bhagavan sarvajñatāsaṅgāpratighātitām up
ādāya |sarvabuddhadharmāveṇikapāramiteyaṃ bhagavan gaṇanāsamatikramatām upādāya |tathāgatatathatāpāramiteyaṃ bhagavan sa
rvadharmāvitathatām upādāya |svayaṃbhūpāramiteyaṃ bhagavan sarvadharmāsvabhāvatām upādāya |sarvajñajñānapāramiteyaṃ bhag
avan yad uta prajñāpāramitā sarvadharmasvabhāvasarvākāraparijñānatām upādāyeti ||

āryāṣṭasāhasrikāyāṃ prajñāpāramitāyāṃ stutiparivarto nāma navamaḥ || (104)

dhāraṇaguṇaparikīrtanaparivarto daśamaḥ |

